11,11,11,11,11,11,11,11,11,11,11,11,11,11,11,11,11,11,11,11
11,11,11,11,11,11,11,11,11,11,11,11,11,11,11,11,11,11,11,11
11,11,11,11,11,11,11,11,11,11,11,11,11,11,11,11,11,11,11,11
11,11,11,11,11,11,11,11,11,11,11,11,11,11,11,11,11,11,11,11
11,11,11,11,11,11,11,11,11,11,11,11,11,11,10,10,10,10,11,11
11,11,11,10,10,19,10,11,10,10,10,10,10,11,10,11,11,10,11,11
11,11,11,10,10,10,10,11,10,24,10,10,10,11,10,11,11,10,11,11
11,11,11,10,21,10,10,18,10,10,10,10,10,11,10,11,11,10,11,11
11,11,11,10,10,10,10,11,10,25,10,10,10,11,10,10,10,10,11,11
11,11,11,10,10,10,10,11,10,10,10,10,10,11,10,10,11,11,11,11
11,11,11,11,11,11,11,11,11,11,11,11,11,11,10,11,10,11,11,11
11,11,11,11,11,11,11,11,11,11,11,11,11,11,10,11,11,10,11,11
11,11,11,11,11,11,11,11,11,11,11,11,11,11,10,11,11,10,11,11
11,11,11,11,11,11,11,11,11,11,11,11,11,11,11,11,11,11,11,11
11,11,11,11,11,11,11,11,11,11,11,11,11,11,11,11,11,11,11,11
